%%%%%%%%%%%%%%%%%%%%%%%%%%%%
%.           %% G          %
% %%%% %%%%% %% %%%%% %%%% %
%o%%%% %%%%% %% %%%%% %%%%o%
% %%%% %%%%% %% %%%%% %%%% %
%                          %
% %%%% %% %%%%%%%% %% %%%% %
% %%%% %% %%%%%%%% %% %%%% %
%      %%    %% G  %%      %
%%%%%% %%%%% %% %%%%% %%%%%%
%%%%%% %%%%% %% %%%%% %%%%%%
%%%%%% %            % %%%%%%
%%%%%% % %%%%  %%%% % %%%%%%
%P       %        %        %
%%%%%% % %%%%%%%%%% % %%%%%%
%%%%%% %            % %%%%%%
%%%%%% % %%%%%%%%%% % %%%%%%
%       G    %%            %
% %%%% %%%%% %% %%%%% %%%% %
% %%%% %%%%% %% %%%%% %%%% %
%o  %%                %%  o%
%%% %% %% %%%%%%%% %% %% %%%
%%% %% %% %%%%%%%% %% %% %%%
%      %%    %%    %%      %
% %%%%%%%%%% %% %%%%%%%%%% %
%G                         %
%%%%%%%%%%%%%%%%%%%%%%%%%%%%
% % % % %%%%%%%%%%%%%%%%%%%%
%%%%%%%%%%%%%%%%%%%%%%%%%%%%
